111111111111111111111
1E000000000000000C001
100000000111000000001
1000C0000000000000001
100000000001111000001
100000000000000000001
100000000000000C00001
111111000C00000000001
100000000001111111101
10000P0001000C000C0C1
111111111111111111111