1111111111111111111111111
10001000010000000000000C1
1011110001011111111111111
1000100001000000000C00001
1000000001000000000000001
10000000010C00C00C0000001
1111111111000000100000001
1000000000000000000000001
100C001000E000P0000000001
1111111111111111111111111