111111111111111111111
11P000111111100111111
110110011111100000001
1000000C00000000000E1
111111111111100111111
111111111111100111111
111111111111100111111
11C111111111100000001
1000000C000000C0000C1
111111111111111111111