1111111111
1C00C10101
1110C00101
10P0110C01
1000C00001
1000E00001
1111111111