1111111111
1C00C10101
1110C00101
10P0110CE1
1111111110