1111111111
1C00C10101
1110C001E1
10P0110C01
1000C00001
10E0000E01
1111111111