1111111111
1C00C10101
1110C00101
10P0110CE1
1000000001
1000000001
1111111111