1111111111111
10010000000C1
1E00011111001


10P0110000001
1111111111111