11111111111111111111111111
11P00011111110000000000011
11011001111110000001111011
1000000C00000000000E111011
11111110111110011111111011
11C11110111110011111111011
11000000111110011111111011
11C10110111110000000111011
1000000C000000C0000C111011
11111111111110111111111011
11111111111110111111111C01
11000011111110011111111101
11011001111110000000111101
1000000C000000000000000001
11111111111110C0000C111011
11111111111110111111111011
11111111111110111111111C01
11000011111110011111111101
11011001111110000000111101
1000000C000000000000000001
11111111111110111111111111
11111111111110111111111111
100000000000000C00000C0001
10100101001000001010010001
10100100101010100010010001
100000000C00C0000000000001
11111111111111111111111111